NO ./textures/red_wall.xpm
EA ./textures/green_sponge.xpm
SO ./textures/grey_wall.xpm
WE ./textures/white_wall.xpm

F 123,123,123
C 1,1,1

11111111111111
10000000000001
10111001111101
101 1000000101
10111000000101
10000000000101
100N0000010001
10000001010101
11111111111111
