NO ./textures/wow.xpm
SO ./textures/wow.xpm
EA ./textures/wow.xpm
WE ./textures/wow.xpm

F 100,100,100
C 200,200,200

   111   111
11110111110111
10000000000001
100000E0000001
11000000000011
 110000000011
  1100000011
   11000011
    110011
     1111
      11
