NO ./textures/wow.xpm
SO ./textures/wow.xpm
WE ./textures/wow.xpm
EA ./textures/wow.xpm

F 246,161,146
C 246,217,146

111111111111111111111
101000001000000000001
101010101011111110001
100010100010000010001111
111110101111101011101
100000101000101000001
101111101011101111111
101000000000000000001
100000000000000000001
100000000000000000001
1000000000N0000000001
10000000000000000000111111
100000000000000000001
111111101011111011101
100000101000100010001
101110101110101110111
101000100000100010101
101011111111111010101
100010000000000010001
101010111011111111101
101000001000000000001
1111111111111111111111
1   1 1 1     111  1
1   1          11
