                NO ./textures/wow.xpm
        SO ./textures/door.xpm
                                                WE ./textures/wow.xpm
EA ./textures/wow.xpm

                        F  	 	49, 25, 7
C 67, 67, 67

111111111111111111111
100000000000000000001
100000000000000000001
100000000000000000001
1000000000N0000000001
100000000000000000001
101000100011D11010101
111111111111111111111
