NO ./textures/door.xpm
EA ./textures/green_sponge.xpm
SO ./textures/wow.xpm
WE ./textures/wow.xpm

F 123,123,123
C 1,1,1

1111111
1111111
1111
 1S111
 111111111
