        SO ./textures/ClaimedE.xpm
                                                WE ./textures/ClaimedE.xpm

                        F 246,161,146
                NO ./textures/ClaimedE.xpm

C 246,217,146
EA ./textures/ClaimedE.xpm

11111111111111111111111111
10000000000000000000000001
100000000000000N0000000001
11111111111111111111111111
