        SO ./textures/ClaimedE.xpm
                                                WE ./textures/ClaimedE.xpm

                        F 246,161,146
                NO ./textures/ClaimedE.xpm

C 246,217,146
EA ./textures/ClaimedE.xpm

1111111111011111111
1000111111111111111
1001111111111111111
1001111111111111111
1101111111111111111
1101111111111111111
1100011111111111111
110N111110011111101
1000011000000111101
1111111111111111111
