                NO ./textures/wow.xpm
        SO ./textures/wow.xpm
                                                WE ./textures/door.xpm
EA ./textures/door.xpm

                        F  	 	49, 25, 7
C 67, 67, 67

111111111111111111111
101000001000000000001
101010101011111110001
100010100010000010001111
111110101111101011101
100000101000101000001
101111101001101111111
101000000101000000001
100000000000000000001
100000000000000000001
1000000000S0000000001
10000000000000000000111111
100000000000000000001
111111101011111011101
100000101000100010001
101110101110101110111
101000100000100010101
101011111111111010101
100010000000000010001
101010111011111111101
111000001000000000001
1111111111111111111111
                    1
					1
					1
					1
					1
					1
